date,Confirmed,newConfirmed,Deaths,newDeaths,Est.Recovered,newEst.Recovered,Est.Active,newEst.Active,Recovered,newRecovered,Active,newActive
01-25-2020,1,1,0,0,0,0,1,1,0,0,1,1
01-26-2020,4,3,0,0,0,0,4,3,0,0,4,3
01-27-2020,6,2,0,0,0,0,6,2,0,0,6,2
01-28-2020,6,0,0,0,0,0,6,0,0,0,6,0
01-29-2020,6,0,0,0,0,0,6,0,0,0,6,0
01-30-2020,8,2,0,0,0,0,8,2,0,0,8,2
01-31-2020,8,0,0,0,0,0,8,0,0,0,8,0
02-01-2020,9,1,0,0,0,0,9,1,0,0,9,1
02-02-2020,11,2,0,0,0,0,11,2,0,0,11,2
02-03-2020,15,4,0,0,0,0,15,4,0,0,15,4
02-04-2020,17,2,0,0,0,0,17,2,0,0,17,2
02-05-2020,17,0,0,0,3,3,14,-3,3,3,14,-3
02-06-2020,18,1,0,0,3,0,15,1,3,0,15,1
02-07-2020,18,0,0,0,3,0,15,0,3,0,15,0
02-08-2020,18,0,0,0,3,0,15,0,3,0,15,0
02-09-2020,18,0,0,0,3,0,15,0,3,0,15,0
02-10-2020,18,0,0,0,4,1,14,-1,3,0,15,0
02-11-2020,18,0,0,0,5,1,13,-1,5,2,13,-2
02-12-2020,18,0,0,0,9,4,9,-4,9,4,9,-4
02-13-2020,18,0,0,0,11,2,7,-2,11,2,7,-2
02-14-2020,18,0,0,0,11,0,7,0,11,0,7,0
02-15-2020,18,0,0,0,13,2,5,-2,13,2,5,-2
02-16-2020,18,0,0,0,13,0,5,0,13,0,5,0
02-17-2020,18,0,0,0,13,0,5,0,13,0,5,0
02-18-2020,18,0,0,0,15,2,3,-2,15,2,3,-2
02-19-2020,18,0,0,0,16,1,2,-1,16,1,2,-1
02-20-2020,18,0,0,0,18,2,0,-2,18,2,0,-2
02-21-2020,18,0,0,0,18,0,0,0,18,0,0,0
02-22-2020,18,0,0,0,18,0,0,0,18,0,0,0
02-23-2020,18,0,0,0,18,0,0,0,18,0,0,0
02-24-2020,18,0,0,0,18,0,0,0,18,0,0,0
02-25-2020,18,0,0,0,18,0,0,0,18,0,0,0
02-26-2020,18,0,0,0,18,0,0,0,18,0,0,0
02-27-2020,18,0,0,0,18,0,0,0,18,0,0,0
02-28-2020,18,0,0,0,18,0,0,0,18,0,0,0
02-29-2020,18,0,0,0,18,0,0,0,18,0,0,0
03-01-2020,18,0,0,0,18,0,0,0,18,0,0,0
03-02-2020,18,0,0,0,18,0,0,0,18,0,0,0
03-03-2020,18,0,0,0,18,0,0,0,18,0,0,0
03-04-2020,18,0,0,0,18,0,0,0,18,0,0,0
03-05-2020,18,0,0,0,18,0,0,0,18,0,0,0
03-06-2020,18,0,0,0,18,0,0,0,18,0,0,0
03-07-2020,18,0,0,0,18,0,0,0,18,0,0,0
03-08-2020,18,0,0,0,18,0,0,0,18,0,0,0
03-09-2020,18,0,0,0,18,0,0,0,18,0,0,0
03-10-2020,18,0,0,0,18,0,0,0,18,0,0,0
03-11-2020,18,0,0,0,18,0,0,0,18,0,0,0
03-12-2020,18,0,0,0,18,0,0,0,18,0,0,0
03-13-2020,18,0,0,0,18,0,0,0,18,0,0,0
03-14-2020,18,0,0,0,18,0,0,0,18,0,0,0
03-15-2020,18,0,0,0,18,0,0,0,18,0,0,0
03-16-2020,18,0,0,0,18,0,0,0,18,0,0,0
03-17-2020,18,0,0,0,18,0,0,0,18,0,0,0
03-18-2020,18,0,0,0,18,0,0,0,18,0,0,0
03-19-2020,18,0,0,0,18,0,0,0,18,0,0,0
03-20-2020,18,0,0,0,18,0,0,0,18,0,0,0
03-21-2020,18,0,0,0,18,0,0,0,18,0,0,0
03-22-2020,18,0,0,0,18,0,0,0,18,0,0,0
03-23-2020,18,0,0,0,18,0,0,0,18,0,0,0
03-24-2020,18,0,0,0,18,0,0,0,18,0,0,0
03-25-2020,18,0,0,0,18,0,0,0,18,0,0,0
03-26-2020,18,0,0,0,18,0,0,0,18,0,0,0
03-27-2020,18,0,0,0,18,0,0,0,18,0,0,0
03-28-2020,18,0,0,0,18,0,0,0,18,0,0,0
03-29-2020,18,0,0,0,18,0,0,0,18,0,0,0
03-30-2020,18,0,0,0,18,0,0,0,18,0,0,0
03-31-2020,18,0,0,0,18,0,0,0,18,0,0,0
04-01-2020,18,0,0,0,18,0,0,0,18,0,0,0
04-02-2020,18,0,0,0,18,0,0,0,18,0,0,0
04-03-2020,18,0,0,0,18,0,0,0,18,0,0,0
04-04-2020,18,0,0,0,18,0,0,0,18,0,0,0
04-05-2020,18,0,0,0,18,0,0,0,18,0,0,0
04-06-2020,18,0,0,0,18,0,0,0,18,0,0,0
04-07-2020,18,0,0,0,18,0,0,0,18,0,0,0
04-08-2020,18,0,0,0,18,0,0,0,18,0,0,0
04-09-2020,18,0,0,0,18,0,0,0,18,0,0,0
04-10-2020,18,0,0,0,18,0,0,0,18,0,0,0
04-11-2020,18,0,0,0,18,0,0,0,18,0,0,0
04-12-2020,18,0,0,0,18,0,0,0,18,0,0,0
04-13-2020,18,0,0,0,18,0,0,0,18,0,0,0
04-14-2020,18,0,0,0,18,0,0,0,18,0,0,0
04-15-2020,18,0,0,0,18,0,0,0,18,0,0,0
04-16-2020,18,0,0,0,18,0,0,0,18,0,0,0
04-17-2020,18,0,0,0,18,0,0,0,18,0,0,0
04-18-2020,18,0,0,0,18,0,0,0,18,0,0,0
04-19-2020,18,0,0,0,18,0,0,0,18,0,0,0
04-20-2020,18,0,0,0,18,0,0,0,18,0,0,0
04-21-2020,18,0,0,0,18,0,0,0,18,0,0,0
04-22-2020,18,0,0,0,18,0,0,0,18,0,0,0
04-23-2020,18,0,0,0,18,0,0,0,18,0,0,0
04-24-2020,18,0,0,0,18,0,0,0,18,0,0,0
04-25-2020,18,0,0,0,18,0,0,0,18,0,0,0
04-26-2020,18,0,0,0,18,0,0,0,18,0,0,0
04-27-2020,18,0,0,0,18,0,0,0,18,0,0,0
04-28-2020,18,0,0,0,18,0,0,0,18,0,0,0
04-29-2020,18,0,0,0,18,0,0,0,18,0,0,0
04-30-2020,18,0,0,0,18,0,0,0,18,0,0,0
05-01-2020,18,0,0,0,18,0,0,0,18,0,0,0
05-02-2020,18,0,0,0,18,0,0,0,18,0,0,0
05-03-2020,18,0,0,0,18,0,0,0,18,0,0,0
05-04-2020,18,0,0,0,18,0,0,0,18,0,0,0
05-05-2020,18,0,0,0,18,0,0,0,18,0,0,0
05-06-2020,18,0,0,0,18,0,0,0,18,0,0,0
05-07-2020,18,0,0,0,18,0,0,0,18,0,0,0
05-08-2020,18,0,0,0,18,0,0,0,18,0,0,0
05-09-2020,18,0,0,0,18,0,0,0,18,0,0,0
05-10-2020,18,0,0,0,18,0,0,0,18,0,0,0
05-11-2020,18,0,0,0,18,0,0,0,18,0,0,0
05-12-2020,18,0,0,0,18,0,0,0,18,0,0,0
05-13-2020,18,0,0,0,18,0,0,0,18,0,0,0
05-14-2020,18,0,0,0,18,0,0,0,18,0,0,0
05-15-2020,18,0,0,0,18,0,0,0,18,0,0,0
05-16-2020,18,0,0,0,18,0,0,0,18,0,0,0
05-17-2020,18,0,0,0,18,0,0,0,18,0,0,0
05-18-2020,18,0,0,0,18,0,0,0,18,0,0,0
05-19-2020,18,0,0,0,18,0,0,0,18,0,0,0
05-20-2020,18,0,0,0,18,0,0,0,18,0,0,0
05-21-2020,18,0,0,0,18,0,0,0,18,0,0,0
05-22-2020,18,0,0,0,18,0,0,0,18,0,0,0
05-23-2020,18,0,0,0,18,0,0,0,18,0,0,0
05-24-2020,18,0,0,0,18,0,0,0,18,0,0,0
05-25-2020,18,0,0,0,18,0,0,0,18,0,0,0
05-26-2020,18,0,0,0,18,0,0,0,18,0,0,0
05-27-2020,18,0,0,0,18,0,0,0,18,0,0,0
05-28-2020,18,0,0,0,18,0,0,0,18,0,0,0
05-29-2020,18,0,0,0,18,0,0,0,18,0,0,0
05-30-2020,18,0,0,0,18,0,0,0,18,0,0,0
05-31-2020,18,0,0,0,18,0,0,0,18,0,0,0
06-01-2020,18,0,0,0,18,0,0,0,18,0,0,0
06-02-2020,18,0,0,0,18,0,0,0,18,0,0,0
06-03-2020,18,0,0,0,18,0,0,0,18,0,0,0
06-04-2020,18,0,0,0,18,0,0,0,18,0,0,0
06-05-2020,18,0,0,0,18,0,0,0,18,0,0,0
06-06-2020,18,0,0,0,18,0,0,0,18,0,0,0
06-07-2020,18,0,0,0,18,0,0,0,18,0,0,0
06-08-2020,18,0,0,0,18,0,0,0,18,0,0,0
06-09-2020,18,0,0,0,18,0,0,0,18,0,0,0
06-10-2020,18,0,0,0,18,0,0,0,18,0,0,0
06-11-2020,18,0,0,0,18,0,0,0,18,0,0,0
06-12-2020,18,0,0,0,18,0,0,0,18,0,0,0
06-13-2020,18,0,0,0,18,0,0,0,18,0,0,0
06-14-2020,18,0,0,0,18,0,0,0,18,0,0,0
06-15-2020,18,0,0,0,18,0,0,0,18,0,0,0
06-16-2020,18,0,0,0,18,0,0,0,18,0,0,0
06-17-2020,18,0,0,0,18,0,0,0,18,0,0,0
06-18-2020,18,0,0,0,18,0,0,0,18,0,0,0
06-19-2020,18,0,0,0,18,0,0,0,18,0,0,0
06-20-2020,18,0,0,0,18,0,0,0,18,0,0,0
06-21-2020,18,0,0,0,18,0,0,0,18,0,0,0
06-22-2020,18,0,0,0,18,0,0,0,18,0,0,0
06-23-2020,18,0,0,0,18,0,0,0,18,0,0,0
06-24-2020,18,0,0,0,18,0,0,0,18,0,0,0
06-25-2020,18,0,0,0,18,0,0,0,18,0,0,0
06-26-2020,18,0,0,0,18,0,0,0,18,0,0,0
06-27-2020,18,0,0,0,18,0,0,0,18,0,0,0
06-28-2020,18,0,0,0,18,0,0,0,18,0,0,0
06-29-2020,18,0,0,0,18,0,0,0,18,0,0,0
06-30-2020,18,0,0,0,18,0,0,0,18,0,0,0
07-01-2020,18,0,0,0,18,0,0,0,18,0,0,0
07-02-2020,18,0,0,0,18,0,0,0,18,0,0,0
07-03-2020,18,0,0,0,18,0,0,0,18,0,0,0
07-04-2020,18,0,0,0,18,0,0,0,18,0,0,0
07-05-2020,18,0,0,0,18,0,0,0,18,0,0,0
07-06-2020,18,0,0,0,18,0,0,0,18,0,0,0
07-07-2020,18,0,0,0,18,0,0,0,18,0,0,0
07-08-2020,18,0,0,0,18,0,0,0,18,0,0,0
07-09-2020,18,0,0,0,18,0,0,0,18,0,0,0
07-10-2020,18,0,0,0,18,0,0,0,18,0,0,0
07-11-2020,18,0,0,0,18,0,0,0,18,0,0,0
07-12-2020,18,0,0,0,18,0,0,0,18,0,0,0
07-13-2020,18,0,0,0,18,0,0,0,18,0,0,0
07-14-2020,18,0,0,0,18,0,0,0,18,0,0,0
07-15-2020,18,0,0,0,18,0,0,0,18,0,0,0
07-16-2020,18,0,0,0,18,0,0,0,18,0,0,0
07-17-2020,18,0,0,0,18,0,0,0,18,0,0,0
07-18-2020,18,0,0,0,18,0,0,0,18,0,0,0
07-19-2020,18,0,0,0,18,0,0,0,18,0,0,0
07-20-2020,18,0,0,0,18,0,0,0,18,0,0,0
07-21-2020,18,0,0,0,18,0,0,0,18,0,0,0
07-22-2020,18,0,0,0,18,0,0,0,18,0,0,0
07-23-2020,18,0,0,0,18,0,0,0,18,0,0,0
07-24-2020,18,0,0,0,18,0,0,0,18,0,0,0
07-25-2020,18,0,0,0,18,0,0,0,18,0,0,0
07-26-2020,18,0,0,0,18,0,0,0,18,0,0,0
07-27-2020,18,0,0,0,18,0,0,0,18,0,0,0
07-28-2020,18,0,0,0,18,0,0,0,18,0,0,0
07-29-2020,18,0,0,0,18,0,0,0,18,0,0,0
07-30-2020,18,0,0,0,18,0,0,0,18,0,0,0
07-31-2020,18,0,0,0,18,0,0,0,18,0,0,0
08-01-2020,18,0,0,0,18,0,0,0,18,0,0,0
08-02-2020,18,0,0,0,18,0,0,0,18,0,0,0
08-03-2020,18,0,0,0,18,0,0,0,18,0,0,0
08-04-2020,18,0,0,0,18,0,0,0,18,0,0,0
08-05-2020,18,0,0,0,18,0,0,0,18,0,0,0
08-06-2020,18,0,0,0,18,0,0,0,18,0,0,0
08-07-2020,18,0,0,0,18,0,0,0,18,0,0,0
08-08-2020,18,0,0,0,18,0,0,0,18,0,0,0
08-09-2020,18,0,0,0,18,0,0,0,18,0,0,0
08-10-2020,18,0,0,0,18,0,0,0,18,0,0,0
08-11-2020,18,0,0,0,18,0,0,0,18,0,0,0
08-12-2020,18,0,0,0,18,0,0,0,18,0,0,0
08-13-2020,18,0,0,0,18,0,0,0,18,0,0,0
08-14-2020,18,0,0,0,18,0,0,0,18,0,0,0
08-15-2020,18,0,0,0,18,0,0,0,18,0,0,0
08-16-2020,18,0,0,0,18,0,0,0,18,0,0,0
08-17-2020,18,0,0,0,18,0,0,0,18,0,0,0
08-18-2020,18,0,0,0,18,0,0,0,18,0,0,0
08-19-2020,18,0,0,0,18,0,0,0,18,0,0,0
08-20-2020,18,0,0,0,18,0,0,0,18,0,0,0
08-21-2020,18,0,0,0,18,0,0,0,18,0,0,0
08-22-2020,18,0,0,0,18,0,0,0,18,0,0,0
08-23-2020,18,0,0,0,18,0,0,0,18,0,0,0
08-24-2020,18,0,0,0,18,0,0,0,18,0,0,0
08-25-2020,18,0,0,0,18,0,0,0,18,0,0,0
